111111
1C1011
100001
10E0P1
111111