111111
1C1011
110001
10E0P1
111111
