111111111111111111
10000000000001C001
100C001111000010E1
100000000000000001
100000001111100001
10000C000000000001
1P00000000000C0001
111111111111111111